R  1800 1240
NO ./images/greystone.xpm
SO ./images/redbrick.xpm
WE ./images/colorstone.xpm
EA ./images/wood.xpm
S  ./images/barrel.xpm
F  28,19,0
C  40,57,97

11111111111111111111111111111111111111111111111111111111111111111111111111111111111111111111111111111111111111111111111111111111111111111111111111111111111111111111111111111111111111111111
11001110100001100102001110000000000000110020110000010010021000001001000100000000000000011010000110100000100100010000200100011110011010100000000010010010011010111001100000010000000010100101
10000100001011001000011100000010100100101011011000101011001010000100111100010000000011201100010102111000000100011101000001001010020111011000121010000001000010000010010001010000011001101001
10010000000100001000000011000000001011210110001000000100110100100000101001000000001000010001110002001110011000101010002010001001011001000110000002000000011001000000000000111101110011100001
10002000101000010010010001000111011100010101010000101010000210000101000001001000000010100000110000000010101100001000000001020002000000011000110000101000000000100000000000200200010000100001
10100000001020011011101000100002101010100000100010100100000100000000001000000110120001010100000012010011000000000100120001000002000000010100100000100100100001000010011100000001001100100101
10000000000010100010000101100001000000100010010002000001101100000020000010101100100010010001000000011000101110000000101010010010010100210000110010001000100000010000001010001200000100210101
10000000002010000010000010011001000001000100020000010001011000011000011000001010000000101010001000000100000001000110100011100010200210020000000111000100000101000000110020100000010001110111
11100000000001000000100W00000010000011111010000100110001110100110010100011000001000010000001000101000210000011000001100010000100100020011011000110100000020010111000000100012011000010000011
11000000001100000000000000000200010111010000000000010001111100101000101001100000012000010010100010000001010100000011000011000001200000000010000010110110010100012000001000000011100000101001
11100001000000010000010101011100000001000021000101100000000010000000000000000000010100000000002000200001001110101100100000100010100000000000100000011000100100011000110011010110010111000011
11010100010010000000002001211100110100100100010100100110000000000000011120010010020110110010011001000000001000010100001010000000011001110000001000000000200000000010000000010001100100011001
11000100000000000200010000011000100010000011000000000000000000001001000011111000000010010020010000010010000000010010111000010100000000010001010101000000001000000000000000120000010100000101
10000111000010000011100010000101100000000010010000001000100000000200010002000000010000100110110000121000100000000000000001000101000100101001000001011000000000100001000000000000000001100001
11000010111020110000100002001010101001002000002011010211000000011020100110100101100100000010000000000000101111010001000000000010100002001120000000001000100101010111011010100001002120110001
11000001020000001100101100000000000001110000110001100000100001100000100000000200011100001110000000010002000000100000010000000000000011000101000010100000001001010001000100101010000010000001
10110000021101101000101021011100011001000020100101010020010002100001101000100011000000000010110011000001021000000000011110000100000001000110001001010100110001010000111001012000010000000001
11110000000101010011110010100110000011010012000020010010000111000000001101201000000100001010000120010010010100002110000010100000010000001100011000101020010000101001100010000020101011000011
11201010100010000100010011100011000010000000001000000000010000120000000101100111000000100000000000000000002000000200000101000012120000010210001000000001010111000100000000000200011200100001
10001010100000101000001010100000000001210001000010101001001110001100110001100000011000010110100000001100010021101020010000101000011011101112010001112010001000000000001100010000002001101011
11001100100000000001001100121001000000001011100011000010000011022101000010000101000000011110110100110000121210000010011010110100010100000000010100000000010000010000110000010000201100000111
10000121000111100000000000000110111011000100100010001010010001021102011000000000100100000111001000010000100100001000210110000000101020100101000000000000000200021102200110001000010101001001
10000000000101111010002000001000010010011000121100000010111000010000000011000001110000000100001010001011000000001000000001121100010010100000000100101000000101000100100000001211100100000001
11000001100000001000000001000100000010100011010000001000001000000110000100011001000010000000000010200010000012000010001111110000011100100011100100001010010010000000011000000010001000000201
10011001000101101000021001001111001000010111010000000100000000101000011100010012000000000100010100100010000000121000100000000100001001111000000000110100001210000000000000000000010100200001
10000001100101001010000000100100110000101000010000000000001000110100001001001010010110010110100100100010101101100110010100001010011000000011111100000001001011000001001000002100001100000201
10010100000000001000000000010010000110000100000100001000100000110000100000010200100001001000001000001100000100112000010010010010000001001011001001100000000000111001110010000100010002010001
10010000000000010112010010100010001101001100101000000000010110000000101000110001010211000121210000010010000001000000001000100011100000011000200000001211000010110101010101000100000111012011
11000110111000000000001010021200010000100000021000000000000010011100011000100010010100000100000001011000002000002100010000100101101011011101101000000000011000100100000000110000000011001001
10001020000001000010020001000000000110100000102001111010000001010000001010000001000000000100000010011001100001020000101001100010000000101121011000000000100011001110100120100211000010000001
10001000001000000000100121010100111010000110011000011100010110000001000011000010000000010000000000000000000001100010000101111002111010000000000010011001100100200010000101110000000100002001
10100110000010000001100100001100100000010010011100101101000010000000000002010110000000010011100000101010110110000100110100100001001001000100000001000010000101100010000200010000000200010011
11100001020000100011001000000001111110001111001000000001000110000100011010000100001000111101000120011101000010001001000100000000101000001010000120101101000010011000100100001100110001021001
10100011002011011102101100012100010010000020101100100000000000011000010000000110011001000000100020000021000100110000010000000101010001010010000100000000000000000010020000011011000100000001
10000101101100210102101000000000000000000000100010110011110100000210000100011011000000010101000010000200010000010001101100010001100002101000200000000000000010111100110000100001201000001001
10012101120010011001000000000111001110010100000010002000010001010001000000000001001000010000000001100000011000000010021010000110000210000100101001021011011110100000110011000001010010101001
10101022000000101100000000101100001000100110001101102001111011001000100101001101101000010000000112010100100210101010100110220020010100011000010010000002000121011100000010010100001000111001
10000010010210000110110000100001001000011001100010010001000010010010000011001000101010010010100011000001000101001100100200011100001000000000000000010211101110001200001010100100001000010001
10000000000000200100100010110100000000010200000100101000000000110101000001010010001010010100000110110011100000000020002010000000000010100100001000000000011010010000101011000001000000100001
11101000000001001000000010101000000100000000000011000002000010210010000000201011000000010000010100000002001100101120101010000012000001200010000110112101000100101100011001000010001110000001
11011011101000100000200001000002001010021010000000001000100000100000100110000000010100000001010000001002100010101002010110010000020010000000001000000010102010001010200001000100100011000111
10000100010000000110100100010100100000021101001100001100000011000100100100001010001001000001001000100100000010001010000110000111000000100010200001000000210000011010010001110010100001000001
10000000011110001000001000000121101000111011100110200010001101100122100111000000102000000010100010100000000001000000000010000000100010001000000000000000001000000110111000002000000001010001
11100110000101000000011000010000001010201010011001010101010010000012100010110010000110002000210100000000110010100002010100000001100000100000010010010010000010000100110000001100001001000001
10211011000010000101100010000000000001110110001001000100110011011000001110100110000000000100100000001101000000010000000100100000001010000010000110110010011000111000001101101000000001002001
10010100001020000100001000020001000100010111011001101000000001101201001010101100000210111000101101000010201100000000102101001000000101001000000022001101000100021000100000011200000000000001
10000110000001000000001001000000000000001000000011010001000011000010000000001100001100000001100101000111111010011001011111010001001100110011010000111000000011000011010101000010100000010011
10200000200001010110101000010010010011000000000000010201001101000010012000011010111000000011010001000001010011011200010011010011000100011000010011101001001001001100010000001000000001011101
10001001100010000000010011120000000011020000010010110002000001000001000001101100010011020000001110011000011001100101010100010000110101100011010100000010010011010100000000201010000000210001
10020001110000010000000100000000210010000101002001010000001010000000020010000000110101000000100010000100000010110001010000001100000001000000000000110020000002000100111010000112100011000021
10000010010011001111001110100100002100100110010000010010001001200000100010000001021101000111100000010000101001010000000000000000011110000001001000110000001010000010010010100100001101000101
11000102010010002000100001001010120110000001000000001100100000010100010010000000102101000000000010000000100000110010001111010000000001001001001111100012010000001100000000100002010001010001
10010000021000010100100110000100010001000001001001000002000001000020000100000101000111000010000001111000010000001011000010000000001000001000001010000110000000100001100200000010101011100111
11012000001001001000000010010010001001100121010200000000000000000201101000010000011010101000001100200011000010010100000200101000000000001100001000020010000001011010110010001010110010100011
10000110010000201100000010001100110100000000000000000100011100100010101000001100001000011110010110010000000100100000100000011100100010010010010000010110100020000001020100000000100020101001
10010020001110000001200000000001011001002101001100121011001001002001000010000000010110010101100000200010010010020000001000000110100100000012010000100100100000101001110000000101000010000001
10100001011010100100101001101011000002100010110020010010000000010100001000000100000010100100110100200010000010100100000000010101000001111010000100000101010100000100100000100101001000001001
11010000110100000010211000111021001010000001000112000010000100010000110000020010000000101111000001010001100010000010001001000011000101000101220100201000002000101010000000010010000102000001
10000001000000110000101102010100101011100000000021100100110120001000000000001000000100110000000000000010002100000000010100001000010100000000121000201011020010010011010000200012000000001101
10100000000201000001010000000000001001011000100002110011100000000101100010000111200010000100000100100000000000010101000000100000111010010000101110000100001010010000000120102100002022000101
11111111111111111111111111111111111111111111111111111111111111111111111111111111111111111111111111111111111111111111111111111111111111111111111111111111111111111111111111111111111111111111
