R  1920 1080
NO ./images/greystone.xpm
SO ./images/redbrick.xpm
WE ./images/colorstone.xpm
EA ./images/wood.xpm
S  ./images/pillar.xpm
F  28,19,0
C  40,57,97


                                         11111111111111111
11111111             111111              100000000S0000001
10000001             1010011111111       10111100000111101
11110001   111111    1010001110001       101  1111111  101
10200001   100201    1000000000201       101           101   111111111111111111
100011111 11000011   1000011100001       10111111111111101   110000000000000001
100000201110001001111112011 110011       101           101   110000000000000001
111100001110001000000100001110001        101           101   110000000000000001
1000200100002010001000000001000111       101           101   110111111111111111
1110000100001110010100111100010001       101           10111111011
  11001110011 110010011  1100110111111111101           10000000011
   100111201   1100011    100000000000000001           11111111111
   100010001    11111     111111111111111111                 1111
   100000001                                                 1111
   111111111


