R  1800 1240
NO ./images/greystone.xpm
SO ./images/redbrick.xpm
WE ./images/colorstone.xpm
EA ./images/wood.xpm
S  ./images/barrel.xpm
F  28,19,0
C  40,57,97
                                       11111
11111   1111111111111111111111         10001
12001111102000000000000000000111111111 10N01
10000000000002000020020011110100202001 10001
1200111110201111111110011  10000000001 11011
11111   10001       110111110101010101  101
        10201       110000110202020201  101
        10001       11000011010101010111101
        11111       10000000000000000000001
                    11111111111111111111111
